111111111111111111
1000000000C0000001
1000000000P0000001
10101C000000000101
101000000000010101
1010000C0000010101
101000000000000101
101111111111111101
100000000000000001
1111111111111111C1
1E00000C0000000001
111111111111111111