111111111111
1CP000000001
1C01C0000001
1000000C0001
100C00000001
1000000E0001
111111111111
