111111111111111111
100000000000000001
101111111111111101
101C10C00000000101
101000000C00010101
10100C0000P0010101
101000000E00000101
101111111111111101
100000000000000001
111111111111111111
100000000000000001
111111111111111111