111111111111111111
11P1C0011C000001C1
110001C00011110001
110111111111111101
110111111111111101
110111111111111101
110111111111111101
110111111111111101
110111111111111001
110111111111110011
110111111111100111
110001111111001111
11C100000100011111
110111111000111111
111111111E11111111
111111111111111111
