111111111
10P0000C1
10C0E0001
111111111
